@@@@@@@@@
@..........
@..@...@...
@...%%%....
@......$...
@...P......
@.........@
@...#....@
@..........

