@@@.@.@@@
@..........
...@...@...
@...%%%.@..
@........@.
....P.@...@
@.@.@.....@
@...#..@..
@..........

