@@@@@@@@@
@..........
@..@...@...
@...%%%....
@..........
@...P......
@.........@
@...#.....
@..........

